NO ./textures/north.xpm
SO ./textures/south.xpm
WE ./textures/west.xpm
EA ./textures/east.xpm

F 100,80,60
C 200,220,255

1111111
1000001
100N001
1000001
1111111
