NO ./textures/north.xpm
SO ./textures/south.xpm
WE ./textures/west.xpm
EA ./textures/east.xpm

F 220,100,0
C 225,200,200

1111111111111111111111111
1000000000110000000000001
1011000001110000000000001
1001000000000000000000001
1111111111110000000000001
1000000000110000000000001
1110111111111000000000001
1110111111111000000000001
1100000011010000000000001
1000000000000000000000001
1000000000000000000000001
1100000111010111111110N01
1111011111110101010110001
1111111111111111111111111
