NO ./textures/north.xpm
SO ./textures/south.xpm
WE ./textures/west.xpm
EA ./textures/east.xpm

F 50,50,50
C 135,206,235

111111111
100000001
100010001
100000001
100N00001
100000001
100010001
100000001
111111111
